1111111111
1100000001
122sw22221
1333333331
1444444441
1111111110