1111110011
9100000005
822sw22221
4333333331
5444444440
1111111111