1111111111
10000C0001
10E00C0000
10000C0P01
10000P0E01
1111111111