11111111111111111111111
10000C00000000000000001
10000C00000000000C00001
1000111000000000C000001
100CEP100000000C0000001
11111111111111111111111
