11111111111111111
10000E00000C00001
100C0000000C00001
100P0000000C00001
100C0000000C00001
100C0000000C00001
100C0000000C00001
100C0000000C00001
100C0000000C00001
100C0000000C00001
100C0000000C00001
11111111111111111
