11111
1PEC1
00001
00001
00001
11111
