11111111111111111
10000E0C000000001
10000000000000001
100P0000000000001
11111111111111111
