1111111111
1100000001
222sw22222
3333333333
4444444444
5555555555
