1111111111
10000C0001
10000C0001
1000111001
100CEP1001
1111111111