1111111111
10000C0001
10000C0000
10000C0001
10000P0E01
1111111111