0000000000
1111111111
222sw2222222
3333333333
4444444444
5555555555
