1111111114
0100000000
122sw22221
1333333331
1444444441
1111111000