1111111111111111111111111111111
100000000C000000000000C00010001
1110000C01P1110000C000001110001
10000001110001000000111E0001001
1000011101000100001110100C10001
1000000000010100000000001010001
1111111111111111111111111111111
